%%%%%%%%%%%%%%%%%%%%%%%%%%%%%%%%
%   %. %.%.%       %     %.%.%4%
% % %%       %%  %   %%%   %.% %
% % %. % %%%    %%%% .%..% % % %
% % %% % ..% %   %   %%%%% % % %
% %    %%%%% %%%   %%%.% o % % %
% %% % ..%.  % %%%       %   % %
% %. %%.%%%%...  2  %.%%%%  %% %
% %%  %%%%.%        %%%%.%% .% %
% %   %       %%%.%  .%.. % %% %
% % % o %.%%%   %%% %%%%%    % %
% % % %%%%%   %   % %.. % %% % %
% % %1%..%. %%%%    %%% % .% % %
% %.%   %%%   %  %%       %% % %
%3%.%.%     %       %.%.% .%   %
%%%%%%%%%%%%%%%%%%%%%%%%%%%%%%%%